111111111111111111111111
1000000000C0000000000001
100000P00000000000000001
1000000000E0000000000001
111111111111111111111111
2134534534543245