1111111111111111111111111111111111
1E00000000000001000000000000000011
1010010100100000101001100000010101
1010010010101010001001P00000001011
10000000000000C0000000100000100001
10000000000000C0000000100000100001
10000000000000C0000000100000100001
10000000000000C0000000100000100001
10000000000000C0000000100000100001
10000000000000C0000000100000100001
10000000000000C0000000100000100001
10000000000000C0000000100000100001
10000000000000C0000000100000100001
10000000000000C0000000100000100001
10000000000000C0000000100000100001
10000000000000C0000000100000100001
10000000000000C0000000100000100001
10000000000000C0000000100000100001
10000000000000C0000000100000100001
10000000000000C0000000100000100001
10000000000000C0000000100000100001
10000000000000C0000000100000100001
10000000000000C0000000100000100001
10000000000000C0000000100000100001
10000000000000C0000000100000100001
10000000000000C0000000100000100001
10000000000000C0000000100000100001
10000000000000C0000000100000100001
10000000000000C0000000100000100001
10000000000000C0000000100000100001
10000000000000C0000000100000100001
10000000000000C0000000100000100001
10000000000000C0000000100000100001
10000000000000C0000000100000100001
10000000000000C0000000100000100001
10000000000000C0000000100000100001
10000000000000C0000000100000100001
1111111111111111111111111111111111