11111
10000000000001
10101100010010101
11111000000000001
11111111111111111