11111111111111
10000000000001
10000000000001
10000000000001
10000000000001
10000000000001
10000000000001
10000010000001
100000000P0001
11111111111111
