1111111111111111111111111111111111
1E00000000000001000000000000000011
1010010100100000101001000000010101
10100100101010100010010000000101P1
10000000000000C0000000000000100001
1111111111111111111111111111111111
1111111111111111111111111111111111
