11111111111111111111111111111111111111111111111111
1E0000000000000C00000C0000000000000000000000000001
10100101001000001010010000000000000000000000010101
10100100101010100010010000000101000000000000000001
10100100101010100010010000000101000000000000000001
10100100101010100010010000000100000000001000000001
10100000000010010101010001000000000001000000010101
10100100101010100010010000000000000000000000010101
10100100101010100010000000000000000001000000010101
10100100101010100010000000000000000001000000010101
10100100101010100000000000010000000001000000010101
10100100101000000000010100010000000001000000010101
10100100100000000001010100000000001001000000010101
10100100000000000101010100000000001001000000010101
10100100000000000101010100000000001001000000010101
10100100000000000101010100000000001001000000010101
10100000000000100101010100000000001001000000010101
10100000000000100101010000000010001001000000010101
10100000000000100101010000000010001001000000010101
10100000000000100101010000000010001001000000010101
10100000000000100101010000000010001001000000010101
10100000000000100101010000000010001001000000010101
10100000000000100101010000000010001001000000010101
10100100000000000101010000000010001001000000010101
10100100101010100000000000010010000000000000010101
10100100101010100000000000010000000001000000010101
10100100101010000000000100010000000001000000010101
10100100101000000000010100000000001001000000010101
10100100101000000000010000000010001001000000010101
1P0000000C00000000000C00000000000000000000000000C1
11111111111111111111111111111111111111111111111111