1111111111111111111111111111111111111111111111111111111111111111111111111111111
1E0000000000000C00000C000000000000000000000000000000000000000000000000000000001
1010010100100000101001000000000000000000000001010000000000000000000000000000001
1010010010101010001001000000010100000000000000000000000000000000000000000000001
1010001001010101000100000000000000100000001010000000000000000000000000000000001
1010001001010101000100000000000000100000001010000000000000000000000000000000001
1010001001010101000100000000000000100000001010000000000000000000000000000000001
1010001001010101000100000000000000100000001010000000000000000000000000000000001
1010001001010101000100000000000000100000001010000000000000000000000000000000001
1010001001010101000100000000000000100000001010000000000000000000000000000000001
1010001001010101000100000000000000100000001010000000000000000000000000000000001
1010001001010101000100000000000000100000001010000000000000000000000000000000001
1010001001010101000100000000000000100000001010000000000000000000000000000000001
1010001001010101000100000000000000100000001010000000000000000000000000000000001
1010001001010101000100000000000000100000001010000000000000000000000000000000001
1010001001010101000100000000000000100000001010000000000000000000000000000000001
1010001001010101000100000000000000100000001010000000000000000000000000000000001
1010001001010101000100000000000000100000001010000000000000000000000000000000001
1010001001010101000100000000000000100000001010000000000000000000000000000000001
1010001001010101000100000000000000100000001010000000000000000000000000000000001
1010001001010101000100000000000000100000001010000000000000000000000000000000001
1010001001010101000100000000000000100000001010000000000000000000000000000000001
1010001001010101000100000000000000100000001010000000000000000000000000000000001
1010001001010101000100000000000000100000001010000000000000000000000000000000001
1010001001010101000100000000000000100000001010000000000000000000000000000000001
1010001001010101000100000000000000100000001010000000000000000000000000000000001
1010001001010101000100000000000000100000001010000000000000000000000000000000001
1010001001010101000100000000000000100000001010000000000000000000000000000000001
1010001001010101000100000000000000100000001010000000000000000000000000000000001
1010001001010101000100000000000000100000001010000000000000000000000000000000001
10100010010101010001000000000000001000000010100000000000000000000000000000000P1
1111111111111111111111111111111111111111111111111111111111111111111111111111111
1111111111111111111111111111111111111111111111111111111111111111111111111111111
1111111111111111111111111111111111111111111111111111111111111111111111111111111
1111111111111111111111111111111111000000000000001111111111111111111111111111111
1111111111111111111111111111111111111111111111111111111111111111111111111111111
1111111111111111111111111111111111111111111111111111111111111111111111111111111