111111111111111111111111111111111111111
1C0000000000000000000000000000000000CP1
100000000000000E00000000000000000000001
100000000000000000000000000000000000001
111111111111111111111111111111111111111
