11111111111111111111111111
1E000000000000010000000001
11000101001000001010011001
10000101001000001010011001
100001010010000C1010011001
10000101001000001010011001
10000101001000001010011001
10000101001000001010011001
10000101001000001010011001
10100101001000001010011001
1010010010101010001000P001
10000000000000C00000CCC0C1
11111111111111111111111111
11111110000011111111111111
11111111111111111111111111
