11111111111111111111111111
1E000000000000010000000001
10100101001000001010011001
1010010010101010001001P001
10000000000000C00000CCCCC1
11111111111111111111111111