111111111111111111111111111111111111111
1C0000000000000000000000000000000000C01
100000000000000E0000000000000000000P001
1C0000000000000000000000000000000000C01
1C0000000000000000000000000000000000C01
1C0000000000000000000000000000000000C01
1C0000000000000000000000000000000000C01
1C0000000000000000000000000000000000C01
1C0000000000000000000000000000000000C01
1C0000000000000000000000000000000000C01
1C0000000000000000000000000000000000C01
1C0000000000000000000000000000000000C01
1C0000000000000000000000000000000000C01
1C0000000000000000000000000000000000C01
1C0000000000000000000000000000000000C01
1C0000000000000000000000000000000000C01
1C0000000000000000000000000000000000C01
1C00000CCCCCCCCCCCCCCCCCCCCC00000000C01
1C0000000000000000000000000000000000C01
1C0000000000000000000000000000000000C01
1C00000CCCCCCCCCCCCCCCCCCCCC00000000C01
1C00000CCCCCCCCCCCCCCCCCCCCC00000000C01
1C0000000000000000000000000000000000C01
1C00000CCCCCCCCCCCCCCCCCCCCC00000000C01
1C00000CCCCCCCCCCCCCCCCCCCCC00000000C01
1C00000CCCCCCCCCCCCCCCCCCCCC00000000C01
1C00000CCCCCCCCCCCCCCCCCCCCC00000000C01
1C00000CCCCCCCCCCCCCCCCCCCCC00000000C01
111111111111111111111111111111111111111
