1111111111111111111111111
1110000000111110000001111
1P0000000000E000000000C11
1110000000111110000001111
1111111111111111111111111